111111111111111
100000000P00001
1E0000000000001
111111111111111