111111111111111111111111111110
100000000000000000000000000001
1P0000000000000000000000000001
100000000000000000000000000001
100000000000000C00000000000001
1000000000000C00C00000000E0001
1000000000000C00000C0000000001
1000000000000C0000000000000001
111111111111111111111111111111