111111111111111
100000000C00001
1P0000000000001
111111111111111