111111111111111
1U0000000C0000
1P0000000000E01
111111111111111