111111111111111111111111111111
100000000000000000000000000001
1P00000X0000000000000000000001
10000G000000000000000000000001
100000000000000C00000000000001
1000T00000000C00C00000000E0001
1000000000100C00000C0000000001
1000000010000C0000000000000001
111111111111111111111111111111